0,1 ,1 ,1 ,1 ,1 ,1 ,1,2,1,3,2,1,3,1,1,5
0,11,12,12,12,13,12,12,13,12,12,13,12,12,12,14,5
0,21,6,6,6,7,6,6,7,8,6,6,6,7,8,24,5
0,21,6,6,6,7,6,6,7,6,54,55,6,7,7,24,5
0,21,8,6,54,51,55,6,7,6,1,1,6,7,8,24,5
0,21,6,6,25,78,0,6,7,6,6,6,6,7,7,24,5
0,21,6,6,1,1,1,6,7,6,6,6,6,7,7,24,5
0,21,8,6,6,7,6,6,8,6,6,6,6,7,8,24,5
0,31,32,32,32,33,33,32,33,32,32,32,32,33,33,34,5
40,41,41,41,41,41,41,41,41,41,41,42,41,41,41,41,45